1,1,1,1,1,1,1,1,1,1,1,1,1,1,1,1,1,1,1,1,1,1,1,1,1,1,1,1,1,1,1,
1,2,2,2,2,3,14,2,3,2,2,2,2,3,3,15,2,2,2,3,16,3,2,2,2,13,2,2,17,3,1,
1,2,1,2,1,3,1,2,1,2,1,3,1,2,1,2,1,2,1,3,1,3,1,2,1,2,1,2,1,2,1,
1,2,2,2,2,2,3,2,2,2,3,3,3,2,2,2,2,2,9,3,2,2,2,2,2,3,3,2,2,2,1,
1,2,1,2,1,2,1,2,1,2,1,14,1,2,1,3,1,2,1,2,1,2,1,3,1,2,1,16,1,2,1,
1,3,2,2,2,2,2,2,2,2,2,2,3,2,2,2,2,13,2,2,2,2,2,2,2,2,2,2,3,3,1,
1,2,1,2,1,2,1,3,1,2,1,2,1,2,1,2,1,3,1,2,1,2,1,2,1,2,1,2,1,2,1,
1,2,3,2,2,3,2,3,3,2,3,3,14,2,2,2,2,2,3,2,2,2,3,2,2,2,2,2,3,2,1,
1,3,1,2,1,2,1,2,1,2,1,2,1,2,1,3,1,2,1,2,1,2,1,2,1,2,1,2,1,2,1,
1,2,3,2,17,2,3,3,14,2,2,2,3,2,2,2,2,2,2,2,17,2,2,2,13,2,2,2,3,2,1,
1,2,1,2,1,2,1,2,1,3,1,2,1,3,1,2,1,2,1,2,1,2,1,2,1,2,1,3,1,2,1,
1,2,2,3,3,13,2,3,2,2,2,2,2,3,2,13,2,2,15,16,3,2,3,2,3,2,2,2,15,2,1,
1,1,1,1,1,1,1,1,1,1,1,1,1,1,1,1,1,1,1,1,1,1,1,1,1,1,1,1,1,1,1,
3 5 7
