1,1,1,1,1,1,1,1,1,1,1,1,1,1,1,1,1,1,1,1,1,1,1,1,1,1,1,1,1,1,1
1,2,2,3,2,3,2,2,2,12,2,2,2,2,3,2,2,3,3,2,3,2,3,2,2,2,2,2,2,3,1
1,2,1,2,1,2,1,2,1,3,1,2,1,2,1,3,1,2,1,2,1,2,1,2,1,2,1,3,1,2,1
1,2,2,2,2,3,2,3,2,3,3,3,2,3,3,2,2,2,2,17,2,3,2,11,2,2,3,3,2,2,1
1,2,1,3,1,2,1,2,1,2,1,2,1,2,1,2,1,3,1,2,1,2,1,2,1,2,1,2,1,3,1
1,2,2,2,2,2,2,2,2,2,2,9,2,2,11,2,2,3,3,2,2,2,2,2,2,3,2,2,3,3,1
1,2,1,2,1,3,1,2,1,2,1,2,1,2,1,2,1,3,1,3,1,3,1,3,1,2,1,2,1,2,1
1,2,2,2,3,2,2,2,2,2,2,2,2,3,2,2,2,3,2,3,3,3,2,3,2,2,2,2,2,2,1
1,2,1,2,1,2,1,2,1,3,1,2,1,2,1,2,1,2,1,2,1,2,1,3,1,2,1,3,1,2,1
1,2,2,2,3,3,3,3,2,2,11,2,2,2,2,2,2,3,2,2,2,2,2,2,2,2,2,2,11,2,1
1,2,1,2,1,2,1,2,1,2,1,2,1,2,1,2,1,2,1,3,1,2,1,2,1,17,1,2,1,3,1
1,2,2,3,3,2,3,2,2,2,3,2,2,2,2,17,2,2,2,2,12,2,2,2,2,2,2,2,2,2,1
1,1,1,1,1,1,1,1,1,1,1,1,1,1,1,1,1,1,1,1,1,1,1,1,1,1,1,1,1,1,1
2 9 3