1,1,1,1,1,1,1,1,1,1,1,1,1,1,1,1,1,1,1,1,1,1,1,1,1,1,1,1,1,1,1
1,2,2,2,2,3,3,2,3,3,2,2,2,2,3,2,2,2,12,2,2,2,2,2,2,2,2,2,2,2,1
1,2,1,2,1,2,1,3,1,2,1,2,1,2,1,2,1,2,1,2,1,2,1,2,1,2,1,2,1,2,1
1,3,2,2,2,2,2,3,3,2,3,2,3,2,2,3,2,2,2,3,2,3,3,2,13,2,3,2,2,2,1
1,2,1,2,1,2,1,2,1,2,1,3,1,2,1,2,1,2,1,2,1,2,1,2,1,3,1,2,1,2,1
1,3,2,2,2,3,2,3,2,2,2,2,3,9,3,2,3,2,2,2,3,3,2,2,2,17,2,2,2,2,1
1,2,1,2,1,2,1,2,1,2,1,2,1,2,1,2,1,2,1,2,1,2,1,2,1,2,1,3,1,2,1
1,2,2,2,2,3,2,2,2,2,2,3,2,2,2,17,2,2,2,2,3,2,2,2,2,3,3,2,2,13,1
1,2,1,3,1,2,1,2,1,3,1,3,1,3,1,3,1,12,1,2,1,2,1,11,1,2,1,3,1,2,1
1,2,2,2,2,2,11,2,2,3,2,2,2,3,2,3,2,2,2,2,3,2,2,2,3,2,2,2,2,2,1
1,3,1,2,1,2,1,2,1,2,1,2,1,2,1,2,1,2,1,2,1,2,1,3,1,2,1,2,1,3,1
1,2,3,2,2,2,2,3,2,3,3,2,2,2,2,3,3,2,3,3,3,2,2,17,2,2,11,2,2,2,1
1,1,1,1,1,1,1,1,1,1,1,1,1,1,1,1,1,1,1,1,1,1,1,1,1,1,1,1,1,1,1
1 9 9