13 31
1,1,1,1,1,1,1,1,1,1,1,1,1,1,1,1,1,1,1,1,1,1,1,1,1,1,1,1,1,1,1
1,2,2,2,2,3,3,2,2,3,2,2,2,3,2,2,3,3,2,2,2,3,3,2,3,2,2,3,2,2,1
1,2,1,2,1,2,1,2,1,2,1,2,1,3,1,3,1,2,1,3,1,13,1,2,1,3,1,2,1,2,1
1,2,2,2,2,2,2,3,2,2,2,3,2,2,2,3,2,3,17,2,2,2,2,3,2,2,2,2,2,2,1
1,2,1,2,1,2,1,2,1,2,1,2,1,9,1,3,1,2,1,2,1,2,1,2,1,2,1,2,1,2,1
1,3,2,2,2,3,2,3,2,3,2,2,2,2,2,14,2,2,2,2,11,3,2,2,2,3,2,2,2,2,1
1,2,1,2,1,2,1,2,1,2,1,2,1,3,1,2,1,3,1,2,1,2,1,2,1,2,1,2,1,3,1
1,3,2,2,2,2,3,2,11,3,3,2,2,2,3,2,2,3,2,2,2,2,3,2,2,2,2,13,2,2,1
1,2,1,3,1,2,1,2,1,2,1,3,1,2,1,2,1,2,1,2,1,2,1,2,1,3,1,2,1,2,1
1,2,2,2,2,2,2,2,2,3,3,2,2,3,2,2,3,2,2,3,2,2,2,2,2,2,3,2,2,2,1
1,2,1,3,1,2,1,3,1,2,1,3,1,2,1,3,1,2,1,2,1,14,1,2,1,2,1,2,1,2,1
1,2,2,3,2,3,17,2,2,14,2,2,2,2,2,2,2,2,2,2,13,3,3,2,2,17,3,3,2,2,1
1,1,1,1,1,1,1,1,1,1,1,1,1,1,1,1,1,1,1,1,1,1,1,1,1,1,1,1,1,1,1
5 3 11