1,1,1,1,1,1,1,1,1,1,1,1,1,1,1,1,1,1,1,1,1,1,1,1,1,1,1,1,1,1,1,
1,2,2,2,2,3,2,3,2,12,2,2,3,3,2,2,2,13,2,3,3,3,3,3,2,2,2,16,2,2,1,
1,2,1,2,1,2,1,3,1,2,1,2,1,2,1,2,1,2,1,2,1,3,1,3,1,2,1,2,1,2,1,
1,2,2,2,3,2,2,3,3,3,2,2,2,2,2,2,2,17,2,2,2,3,3,3,2,2,2,3,2,2,1,
1,2,1,2,1,2,1,3,1,2,1,2,1,3,1,2,1,3,1,2,1,2,1,2,1,2,1,2,1,2,1,
1,2,2,2,2,2,2,3,2,2,2,2,3,3,2,13,2,3,3,2,2,2,2,2,2,2,2,2,2,2,1,
1,2,1,2,1,2,1,2,1,2,1,2,1,2,1,2,1,2,1,2,1,3,1,2,1,2,1,2,1,2,1,
1,2,2,2,2,2,2,2,3,3,3,2,2,2,2,12,2,2,2,2,3,3,3,3,2,2,2,9,2,2,1,
1,2,1,2,1,2,1,2,1,2,1,2,1,2,1,2,1,2,1,2,1,3,1,2,1,2,1,2,1,2,1,
1,2,2,2,2,3,14,2,2,2,2,2,3,3,2,2,2,3,3,2,2,2,13,2,2,2,2,2,2,2,1,
1,2,1,2,1,3,1,2,1,2,1,2,1,3,1,2,1,3,1,2,1,3,1,2,1,2,1,2,1,2,1,
1,3,2,17,2,2,3,3,3,2,2,2,2,2,15,2,2,2,2,17,2,2,2,3,3,3,3,2,2,3,1,
1,1,1,1,1,1,1,1,1,1,1,1,1,1,1,1,1,1,1,1,1,1,1,1,1,1,1,1,1,1,1
4 9 7