13 31
1,1,1,1,1,1,1,1,1,1,1,1,1,1,1,1,1,1,1,1,1,1,1,1,1,1,1,1,1,1,1,
1,2,2,2,2,3,3,14,2,2,2,2,2,3,3,2,2,3,2,13,2,3,2,3,2,2,3,3,2,3,1,
1,2,1,2,1,3,1,3,1,2,1,2,1,2,1,2,1,3,1,2,1,2,1,2,1,3,1,2,1,15,1,
1,2,2,2,2,2,2,2,3,2,2,2,2,3,2,2,2,2,3,2,3,3,2,17,2,3,2,2,2,3,1,
1,2,1,2,1,2,1,2,1,2,1,2,1,2,1,2,1,2,1,2,1,2,1,2,1,2,1,3,1,2,1,
1,3,2,2,3,2,2,3,13,2,2,3,2,2,2,2,3,14,2,2,2,2,2,16,2,2,2,13,2,2,1,
1,3,1,2,1,2,1,3,1,2,1,2,1,2,1,3,1,2,1,2,1,2,1,2,1,2,1,2,1,3,1,
1,2,2,2,3,2,2,2,2,2,2,2,2,2,3,2,2,15,2,3,3,2,2,2,3,3,2,2,2,2,1,
1,3,1,2,1,3,1,2,1,3,1,3,1,2,1,2,1,2,1,2,1,2,1,3,1,2,1,3,1,2,1,
1,2,17,2,3,14,2,13,2,2,2,2,2,2,2,9,2,2,3,2,2,2,3,2,2,2,2,2,2,2,1,
1,2,1,2,1,2,1,2,1,3,1,2,1,2,1,3,1,2,1,2,1,2,1,2,1,2,1,2,1,2,1,
1,3,2,3,2,3,3,2,2,2,3,3,2,3,2,2,13,2,2,3,3,2,17,3,2,2,3,2,16,15,1,
1,1,1,1,1,1,1,1,1,1,1,1,1,1,1,1,1,1,1,1,1,1,1,1,1,1,1,1,1,1,1,
8 10 11