13 31
1,1,1,1,1,1,1,1,1,1,1,1,1,1,1,1,1,1,1,1,1,1,1,1,1,1,1,1,1,1,1
1,2,2,3,2,3,13,2,2,2,2,2,2,2,3,2,2,3,3,2,3,2,3,2,2,2,2,2,2,3,1
1,2,1,2,1,2,1,2,1,3,1,2,1,2,1,3,1,2,1,2,1,2,1,2,1,2,1,3,1,2,1
1,2,2,2,2,3,2,3,2,3,3,3,2,3,3,2,2,2,17,2,2,3,2,15,2,2,3,3,2,2,1
1,2,1,3,1,2,1,2,1,2,1,2,1,14,1,2,1,3,1,2,1,2,1,2,1,2,1,2,1,3,1
1,2,2,2,2,2,2,2,2,2,2,3,2,2,2,2,2,3,3,2,2,2,2,2,2,3,2,14,3,3,1
1,2,1,2,1,3,1,2,1,2,1,2,1,2,1,2,1,9,1,3,1,3,1,3,1,2,1,2,1,2,1
1,2,2,2,3,2,2,2,3,2,2,2,2,3,2,2,2,3,2,3,3,3,2,3,2,2,2,3,2,2,1
1,2,1,2,1,2,1,2,1,2,1,2,1,2,1,2,1,2,1,2,1,2,1,2,1,2,1,2,1,2,1
1,2,2,2,3,3,3,3,2,17,2,2,2,2,2,2,2,3,12,2,2,2,2,2,2,13,2,2,2,2,1
1,2,1,3,1,2,1,2,1,2,1,2,1,2,1,2,1,2,1,3,1,2,1,2,1,2,1,2,1,3,1
1,2,2,3,3,2,3,15,2,2,3,2,2,12,3,2,2,2,17,2,2,2,2,2,3,3,2,2,2,2,1
1,1,1,1,1,1,1,1,1,1,1,1,1,1,1,1,1,1,1,1,1,1,1,1,1,1,1,1,1,1,1
2 10 11