13 31
1,1,1,1,1,1,1,1,1,1,1,1,1,1,1,1,1,1,1,1,1,1,1,1,1,1,1,1,1,1,1,
1,2,2,2,2,3,2,2,2,2,2,2,3,3,2,2,15,2,2,2,2,3,2,3,2,2,17,2,2,2,1,
1,2,1,2,1,2,1,2,1,2,1,3,1,2,1,2,1,2,1,2,1,2,1,3,1,2,1,2,1,2,1,
1,2,2,2,2,2,2,2,2,3,3,2,14,2,2,2,3,3,2,2,2,2,3,2,13,2,2,2,16,2,1,
1,2,1,2,1,3,1,2,1,2,1,2,1,2,1,2,1,2,1,3,1,2,1,2,1,2,1,2,1,2,1,
1,3,3,2,2,3,14,2,2,2,2,2,3,2,2,2,2,2,13,2,2,2,2,3,2,3,2,2,2,2,1,
1,2,1,2,1,2,1,3,1,2,1,2,1,2,1,3,1,3,1,2,1,2,1,2,1,3,1,3,1,2,1,
1,2,2,2,2,2,3,2,2,2,2,3,3,3,2,3,2,3,2,3,2,2,2,3,2,2,2,2,2,2,1,
1,2,1,2,1,2,1,2,1,2,1,2,1,2,1,2,1,2,1,2,1,2,1,2,1,2,1,2,1,2,1,
1,17,2,3,3,2,3,2,2,3,3,3,2,2,17,2,2,3,2,2,2,2,2,3,2,3,2,2,2,3,1,
1,2,1,2,1,2,1,3,1,2,1,3,1,2,1,2,1,2,1,2,1,2,1,2,1,2,1,2,1,3,1,
1,3,3,3,2,2,2,2,2,13,2,2,2,2,3,9,3,2,2,2,13,2,2,2,3,2,2,15,2,2,1,
1,1,1,1,1,1,1,1,1,1,1,1,1,1,1,1,1,1,1,1,1,1,1,1,1,1,1,1,1,1,1
6 5 1